aar=Afar
aav=Austro-Asiatic
abk=Abkhaz
ace=Achinese
ach=Acoli
ada=Adangme
ady=Adygei
afa=Afroasiatic (Other)
afh=Afrihili
afr=Afrikaans
ain=Ainu
aka=Akan
akk=Akkadian
alb=Albanian
ale=Aleut
alg=Algonquian (Other)
alt=Altai
alv=Atlantic-Congo
amh=Amharic
ang=English,Old (ca.450-1100)
anp=Angika
apa=Apachelanguages
aqa=Alacalufan
aql=Algic
ara=Arabic
arc=Aramaic
arg=Aragonese
arm=Armenian
arn=Mapuche
arp=Arapaho
art=Artificial (Other)
arw=Arawak
asm=Assamese
ast=Bable
ath=Athapascan (Other)
auf=Arauan
aus=Australianlanguages
ava=Avaric
ave=Avestan
awa=Awadhi
awd=Arawakan
aym=Aymara
azc=Uto-Aztecan
aze=Azerbaijani
bad=Bandalanguages
bai=Bamilekelanguages
bak=Bashkir
bal=Baluchi
bam=Bambara
ban=Balinese
baq=Basque
bas=Basa
bat=Baltic (Other)
bej=Beja
bel=Belarusian
bem=Bemba
ben=Bengali
ber=Berber (Other)
bho=Bhojpuri
bih=Bihari (Other)
bik=Bikol
bin=Edo
bis=Bislama
bla=Siksika
bnt=Bantu (Other)
bos=Bosnian
bra=Braj
bre=Breton
btk=Batak
bua=Buriat
bug=Bugis
bul=Bulgarian
bur=Burmese
byn=Bilin
cad=Caddo
cai=Central American Indian (Other)
car=Carib
cat=Catalan
cau=Caucasian (Other)
cba=Chibchan
ccn=North Caucasian
ccs=South Caucasian
cdc=Chadic
cdd=Caddoan
ceb=Cebuano
cel=Celtic (Other)
cha=Chamorro
chb=Chibcha
che=Chechen
chg=Chagatai
chi=Chinese
chk=Chuukese
chm=Mari
chn=Chinookjargon
cho=Choctaw
chp=Chipewyan
chr=Cherokee
chu=ChurchSlavic
chv=Chuvash
chy=Cheyenne
cmc=Chamiclanguages
cnr=Montenegrin
cop=Coptic
cor=Cornish
cos=Corsican
cpe=CreolesandPidgins,English-based (Other)
cpf=CreolesandPidgins,French-based (Other)
cpp=CreolesandPidgins,Portuguese-based (Other)
cre=Cree
crh=CrimeanTatar
crp=CreolesandPidgins (Other)
csb=Kashubian
csu=CentralSudanic
cus=Cushitic (Other)
cze=Czech
dak=Dakota
dan=Danish
dar=Dargwa
day=Dayak
del=Delaware
den=Slavey
dgr=Dogrib
din=Dinka
div=Divehi
dmn=Mande
doi=Dogri
dra=Dravidian (Other)
dsb=LowerSorbian
dua=Duala
dum=Dutch,Middle (ca.1050-1350)
dut=Dutch
dyu=Dyula
dzo=Dzongkha
efi=Efik
egx=Egyptian
egy=Egyptian (Ancient)
eka=Ekajuk
elx=Elamite
eng=English
enm=English,Middle (1100-1500)
epo=Esperanto
est=Estonian
esx=Eskimo-Aleut
euq=Basque
ewe=Ewe
ewo=Ewondo
fan=Fang
fao=Faroese
fat=Fanti
fij=Fijian
fil=Filipino
fin=Finnish
fiu=Finno-Ugrian (Other)
fon=Fon
fox=Formosan
fre=French
frm=French,Middle (ca.1300-1600)
fro=French,Old (ca.842-1300)
frr=NorthFrisian
frs=EastFrisian
fry=Frisian
ful=Fula
fur=Friulian
gaa=Gã
gay=Gayo
gba=Gbaya
gem=Germanic (Other)
geo=Georgian
ger=German
gez=Ethiopic
gil=Gilbertese
gla=ScottishGaelic
gle=Irish
glg=Galician
glv=Manx
gme=EastGermanic
gmh=German,MiddleHigh (ca.1050-1500)
gmq=NorthGermanic
gmw=WestGermanic
goh=German,OldHigh (ca.750-1050)
gon=Gondi
gor=Gorontalo
got=Gothic
grb=Grebo
grc=Greek,Ancient (to1453)
gre=Greek,Modern (1453-)
grk=Greek
grn=Guarani
gsw=SwissGerman
guj=Gujarati
gwi=Gwich'in
hai=Haida
hat=HaitianFrenchCreole
hau=Hausa
haw=Hawaiian
heb=Hebrew
her=Herero
hil=Hiligaynon
him=WesternPahari
hin=Hindi
hit=Hittite
hmn=Hmong
hmo=HiriMotu
hmx=Hmong-Mien
hok=Hokan
hrv=Croatian
hsb=UpperSorbian
hun=Hungarian
hup=Hupa
hyx=Armenian (Historic)
iba=Iban
ibo=Igbo
ice=Icelandic
ido=Ido
iii=SichuanYi
iir=Indo-Iranian
ijo=Ijo
iku=Inuktitut
ile=Interlingue
ilo=Iloko
ina=Interlingua
inc=Indic (Other)
ind=Indonesian
ine=Indo-European (Other)
inh=Ingush
ipk=Inupiaq
ira=Iranian (Other)
iro=Iroquoian (Other)
ita=Italian
itc=Italic
jav=Javanese
jbo=Lojban
jpn=Japanese
jpr=Judeo-Persian
jpx=JapaneseFamily
jrb=Judeo-Arabic
kaa=Kara-Kalpak
kab=Kabyle
kac=Kachin
kal=Kalaallisut
kam=Kamba
kan=Kannada
kar=Karen
kas=Kashmiri
kau=Kanuri
kaw=Kawi
kaz=Kazakh
kbd=Kabardian
kdo=Kordofanian
kha=Khasi
khi=Khoisan (Other)
khm=Khmer
kho=Khotanese
kik=Kikuyu
kin=Kinyarwanda
kir=Kyrgyz
kmb=Kimbundu
kok=Konkani
kom=Komi
kon=Kongo
kor=Korean
kos=Kosraean
kpe=Kpelle
krc=Karachay-Balkar
krl=Karelian
kro=Kru (Other)
kru=Kurukh
kua=Kuanyama
kum=Kumyk
kur=Kurdish
kut=Kootenai
lad=Ladino
lah=Lahnda
lam=Lamba
lao=Lao
lat=Latin
lav=Latvian
lez=Lezgian
lim=Limburgish
lin=Lingala
lit=Lithuanian
lol=Mongo
loz=Lozi
ltz=Luxembourgish
lua=Luba-Lulua
lub=Luba-Katanga
lug=Ganda
lui=Luiseño
lun=Lunda
luo=Luo
lus=Lushai
mac=Macedonian
mad=Madurese
mag=Magahi
mah=Marshallese
mai=Maithili
mak=Makasar
mal=Malayalam
man=Mandingo
mao=Maori
map=Austronesian (Other)
mar=Marathi
mas=Maasai
may=Malay
mdf=Moksha
mdr=Mandar
men=Mende
mga=Irish,Middle (ca.1100-1550)
mic=Micmac
min=Minangkabau
mkh=Mon-Khmer (Other)
mlg=Malagasy
mlt=Maltese
mnc=Manchu
mni=Manipuri
mno=Manobo
moh=Mohawk
mol=Moldavian
mon=Mongolian
mos=Mooré
mun=Munda (Other)
mus=Creek
mwl=Mirandese
mwr=Marwari
myn=Mayan
myv=Erzya
nah=Nahuatl
nai=NorthAmericanIndian (Other)
nap=Neapolitan
nau=Nauru
nav=Navajo
nbl=Ndebele (SouthAfrica)
nde=Ndebele (Zimbabwe)
ndo=Ndonga
nds=LowGerman
nep=Nepali
new=Newari
ngf=Trans-NewGuinea
nia=Nias
nic=Niger-Kordofanian (Other)
niu=Niuean
nno=NorwegianNynorsk
nob=NorwegianBokmål
nog=Nogai
non=OldNorse
nor=Norwegian
nqo=N'Ko
nso=NorthernSotho
nub=Nubian
nwc=OldNewari
nya=Nyanja
nym=Nyamwezi
nyn=Nyankole
nyo=Nyoro
nzi=Nzima
oci=Occitan
oji=Ojibwa
omq=Oto-Manguean
omv=Omotic
ori=Oriya
orm=Oromo
osa=Osage
oss=Ossetic
ota=OttomanTurkish
oto=Otomian
paa=Papuan (Other)
pag=Pangasinan
pal=Pahlavi
pam=Pampanga
pan=Panjabi
pap=Papiamento
pau=Palauan
peo=OldPersian
per=Persian
phi=Philippine (Other)
phn=Phoenician
plf=CentralMalayo-Polynesian
pli=Pali
pol=Polish
pon=Pohnpeian
por=Portuguese
poz=Malayo-Polynesian
pqe=EasternMalayo-Polynesian
pqw=WesternMalayo-Polynesian
pra=Prakrit
pro=OldProvençal
pus=Pushto
que=Quechua
qwe=Quechuan
raj=Rajasthani
rap=Rapanui
rar=Rarotongan
rcf=ReunionCreole
roa=Romance (Other)
roh=Raeto-Romance
rom=Romani
rum=Romanian
run=Rundi
rup=Aromanian
rus=Russian
sad=Sandawe
sag=Sango
sah=Yakut
sai=SouthAmericanIndian (Other)
sal=Salishan
sam=SamaritanAramaic
san=Sanskrit
sas=Sasak
sat=Santali
scc=Serbian
scn=Sicilian
sco=Scots
scr=Croatian
sdv=EasternSudanic
sel=Selkup
sem=Semitic (Other)
sga=OldIrish
sgn=Signlanguages
shn=Shan
sid=Sidamo
sin=Sinhalese
sio=Siouan (Other)
sit=Sino-Tibetan (Other)
sla=Slavic (Other)
slo=Slovak
slv=Slovenian
sma=SouthernSami
sme=NorthernSami
smi=Sami
smj=LuleSami
smn=InariSami
smo=Samoan
sms=SkoltSami
sna=Shona
snd=Sindhi
snk=Soninke
sog=Sogdian
som=Somali
son=Songhai
sot=Sotho
spa=Spanish
sqi=Albanian
srd=Sardinian
srn=Sranan
srp=Serbian
srr=Serer
ssa=Nilo-Saharan (Other)
ssw=Swazi
suk=Sukuma
sun=Sundanese
sus=Susu
sux=Sumerian
swa=Swahili
swe=Swedish
syc=Syriac
syd=Samoyedic
syr=ModernSyriac
tah=Tahitian
tai=Tai (Other)
tam=Tamil
tat=Tatar
tbq=Tibeto-Burman
tel=Telugu
tem=Temne
ter=Terena
tet=Tetum
tgk=Tajik
tgl=Tagalog
tha=Thai
tib=Tibetan
tig=Tigré
tir=Tigrinya
tiv=Tiv
tkl=Tokelauan
tlh=Klingon
tli=Tlingit
tmh=Tamashek
tog=Tonga (Nyasa)
ton=Tongan
tpi=TokPisin
trk=Turkic
tsi=Tsimshian
tsn=Tswana
tso=Tsonga
tuk=Turkmen
tum=Tumbuka
tup=Tupi
tur=Turkish
tut=Altaic (Other)
tuw=Tungus
tvl=Tuvaluan
twi=Twi
tyv=Tuvinian
udm=Udmurt
uga=Ugaritic
uig=Uighur
ukr=Ukrainian
umb=Umbundu
und=Undetermined
urd=Urdu
urj=Uralic
uzb=Uzbek
vai=Vai
ven=Venda
vie=Vietnamese
vol=Volapük
vot=Votic
wak=Wakashan
wal=Wolayta
war=Waray
was=Washoe
wel=Welsh
wen=Sorbian (Other)
wln=Walloon
wol=Wolof
xal=Oirat
xgn=Mongolic
xho=Xhosa
xnd=Na-Dene
yao=Yao
yap=Yapese
yid=Yiddish
yor=Yoruba
ypk=Yupik
zap=Zapotec
zbl=Blissymbolics
zen=Zenaga
zgh=Tamazight
zha=Zhuang
zhx=ChineseFamily
zle=EastSlavic
zls=SouthSlavic
zlw=WestSlavic
znd=Zande
zul=Zulu
zun=Zuni
zza=Zaza
zxx=Nolinguisticcontent
???=Unknown
mul=Multiplelanguages
mis=Miscellaneouslanguages
